5 5 5 5 5 5 5 5 5 5 5 5 5 5 5 5 5 5 5 5 5 5 5 5 5 5 5 5 5 5
6 3 3 3 3 3 3 3 3 6 0 0 0 0 6 0 0 0 0 0 0 0 0 0 0 0 0 0 0 6 
6 3 3 3 3 3 3 3 3 0 0 0 0 0 6 0 0 0 0 0 0 0 0 0 0 0 0 0 0 6
6 3 3 3 3 3 3 3 3 0 0 0 0 0 6 5 5 5 5 5 5 5 5 5 5 0 0 0 0 6
6 3 3 3 3 3 3 3 3 6 0 0 0 0 6 0 0 0 0 0 0 0 0 0 6 0 0 0 0 6  
6 5 5 5 5 5 5 5 5 6 0 0 0 0 6 0 0 0 0 0 0 0 0 0 0 0 0 0 0 6    
6 0 0 0 0 0 0 0 0 0 0 0 0 0 0 0 0 0 0 0 0 0 0 0 0 0 0 0 0 6   
6 0 0 0 0 0 0 0 0 0 0 0 0 5 5 5 5 5 5 5 0 0 0 0 6 0 0 0 0 11      
6 0 0 0 0 0 0 0 0 6 0 0 0 6 3 3 3 3 3 6 0 0 0 0 6 0 0 0 0 12       
6 5 5 5 5 0 0 5 5 5 0 0 0 3 3 3 3 3 3 3 0 0 0 0 0 0 0 0 0 13        
6 0 0 0 0 0 0 0 0 6 0 0 0 3 3 3 3 3 3 3 0 0 0 0 0 0 0 0 0 14
6 0 0 0 0 0 0 0 0 0 0 0 0 6 3 3 3 3 3 6 0 0 0 0 6 0 0 0 0 15         
6 0 0 0 0 0 0 0 0 0 0 0 0 5 5 5 5 5 5 5 0 0 0 0 6 0 0 0 0 6        
6 5 8 0 6 5 8 0 6 0 0 0 0 0 0 0 0 0 0 0 0 0 0 0 6 0 0 0 0 6
6 7 7 7 6 7 7 7 6 0 0 0 0 0 0 0 6 5 5 5 5 5 5 5 6 0 0 0 0 6
6 7 7 9 6 7 7 9 6 0 0 0 0 0 0 0 6 0 0 0 0 0 0 0 0 0 0 0 0 6
6 10 7 7 6 10 7 7 6 0 0 0 0 0 0 0 6 0 0 0 0 0 0 0 0 0 0 0 0 6        
6 5 5 5 5 5 5 5 5 5 5 5 5 5 5 5 5 5 5 5 5 5 5 5 5 5 5 5 5 6