27 15 15 15 15 15 15 15 15 15 15 15 15 15 15 15 15 15 32 15 15 15 15 15 15 15 15 15 15 28
16 10 10 10 10 10 10 10 10 10 10 10 10 10 10 10 10 10 16 11 11 11 11 11 11 11 11 11 11 16
16 10 10 10 10 10 10 10 10 10 10 10 10 10 10 10 10 10 16 11 11 11 11 11 11 11 11 11 11 16
16 10 10 16 10 10 10 10 10 16 10 10 10 10 10 10 10 10 16 11 11 11 11 11 11 11 11 11 11 16
16 10 10 16 10 10 10 10 10 16 10 10 10 10 27 15 15 15 30 11 11 11 11 11 11 11 11 11 11 16
16 10 10 29 15 28 10 10 10 16 10 10 10 10 16 10 10 10 10 11 11 11 11 11 11 11 11 11 11 16
16 10 10 10 10 33 15 15 15 30 10 10 10 10 10 10 10 10 10 15 15 15 15 15 32 15 15 15 15 30
16 10 10 10 10 16 10 10 10 10 10 10 10 10 10 10 10 10 10 10 10 10 10 10 16 10 10 10 10 10
16 10 10 10 10 16 10 10 10 10 10 10 10 10 16 10 10 10 10 10 10 10 10 10 10 10 10 10 10 10
33 15 15 15 15 30 14 14 14 15 32 15 15 15 35 15 15 15 28 10 10 10 10 10 10 10 10 10 10 10
16 14 14 14 14 14 14 14 14 14 16 20 17 17 16 20 17 17 16 10 10 10 10 10 10 10 10 10 10 10
16 14 14 14 14 14 14 14 14 14 16 17 17 17 16 17 17 17 16 10 10 15 15 15 28 10 10 10 10 10
16 14 14 14 14 14 14 14 14 14 16 17 17 17 16 17 17 17 16 10 10 10 10 10 33 15 15 15 15 28
16 14 14 14 14 14 15 15 32 15 30 10 26 15 30 10 26 15 30 10 10 10 10 10 16 10 10 10 10 16
16 10 10 10 10 10 10 10 16 10 10 10 10 10 10 10 10 10 10 10 10 10 10 10 10 10 10 10 10 16
16 10 10 10 10 10 10 10 10 10 10 10 10 10 10 10 10 10 10 10 10 10 10 10 10 10 10 10 10 16
16 10 10 10 10 10 10 10 10 10 10 10 10 10 10 10 10 10 10 10 10 10 10 10 16 10 10 10 10 16
29 15 15 15 15 15 15 15 15 15 15 15 15 15 15 15 15 15 15 15 15 15 15 15 31 15 15 15 15 30 