27 15 15 15 15 15 15 15 15 32 15 15 15 15 32 15 15 15 15 15 15 15 15 15 15 15 15 15 15 28
16 41 42 40 51 52 40 41 42 16 70 70 70 70 70 70 39 39 39 39 62 63 39 62 63 62 63 39 61 16
16 40 40 40 40 40 40 40 40 70 70 70 70 70 70 70 39 39 39 39 39 39 39 39 39 39 39 39 39 16
16 40 40 40 40 40 40 40 40 70 70 70 70 70 70 70 39 39 39 39 39 39 39 39 39 39 39 39 39 16
16 45 46 40 47 47 40 40 40 16 70 70 70 70 70 15 15 15 77 78 15 15 28 39 39 39 39 39 39 16
33 15 15 15 32 15 15 15 32 30 70 70 70 70 70 70 70 70 70 70 70 70 16 64 65 39 39 64 65 16
16 20 17 19 16 20 17 19 16 70 70 70 70 70 70 70 70 70 70 70 70 70 29 15 15 70 70 15 15 30
16 17 17 17 16 17 17 17 16 70 70 70 70 27 15 15 15 15 15 28 70 70 70 57 56 56 56 56 56 70
16 17 17 17 16 17 17 17 16 70 70 70 70 16 73 74 73 74 40 16 70 70 70 58 56 56 56 56 56 70
33 15 18 70 31 15 18 70 30 70 70 70 70 40 40 40 40 40 40 40 70 70 70 59 56 56 56 56 56 70
16 70 70 70 70 70 70 70 70 70 70 70 70 40 40 40 40 40 40 40 70 70 70 60 56 56 56 56 56 70
16 70 70 70 70 70 70 70 70 70 70 70 70 16 40 40 40 40 40 16 70 70 70 56 56 56 56 56 56 70
16 70 70 70 70 70 70 70 70 70 70 70 70 29 15 15 15 15 15 30 70 70 27 15 48 49 70 70 15 28
33 15 18 70 27 15 18 70 28 70 70 70 70 70 70 70 70 70 70 70 70 70 16 50 14 14 14 14 14 16
16 17 17 17 16 17 17 17 16 70 70 70 70 70 70 70 27 15 15 15 15 15 30 14 14 14 14 14 75 16
16 17 17 17 16 17 17 17 16 70 70 70 70 70 70 70 16 55 14 14 53 54 14 14 14 14 14 14 76 16
16 20 17 19 16 20 17 19 16 70 70 70 70 70 70 70 16 14 14 14 14 14 14 14 14 14 14 14 14 16
29 15 15 15 31 15 15 15 31 15 15 15 15 15 15 15 31 15 15 15 15 15 15 15 15 15 15 15 15 30