27 15 15 15 15 15 15 15 15 15 15 15 15 15 15 15 15 15 15 15 15 15 15 15 15 32 15 15 15 28
16 10 10 10 10 10 10 10 10 10 10 10 10 10 10 10 10 10 10 10 10 10 10 10 10 16 10 10 10 16
16 10 10 10 10 10 10 10 10 10 10 10 10 10 10 10 10 10 10 10 10 10 10 10 10 10 10 10 10 16
16 10 10 16 10 10 10 10 10 10 10 15 15 15 28 10 10 10 10 10 10 10 10 10 10 10 10 10 10 16
16 10 10 16 10 10 16 10 10 10 10 10 10 10 16 10 10 10 10 10 27 15 15 15 15 28 10 10 10 16
16 10 10 16 10 10 16 10 10 10 10 10 10 10 16 10 10 15 15 15 34 10 10 10 10 16 10 10 10 16
16 10 10 16 10 10 16 10 10 10 10 10 10 10 16 10 10 10 10 10 16 10 10 10 10 16 10 10 10 16
16 10 10 16 10 10 16 10 10 10 10 10 10 10 16 10 10 10 10 10 16 10 10 10 10 10 10 10 10 21
16 10 10 16 10 10 16 10 10 10 10 10 10 10 16 10 10 10 10 10 16 10 10 10 10 10 10 10 10 22
16 10 10 16 10 10 33 15 15 15 32 15 10 10 29 15 15 10 10 10 29 15 15 15 15 28 10 10 10 23
16 10 10 16 10 10 16 10 10 10 16 10 10 10 10 10 10 10 10 10 10 10 10 10 10 16 10 10 10 24
16 10 10 16 10 10 16 10 10 10 16 10 10 10 10 10 10 10 10 10 10 10 10 10 10 16 10 10 10 25
16 10 10 16 10 10 16 10 10 10 10 10 10 10 10 10 16 10 10 10 16 10 10 10 10 10 10 10 10 16
16 10 10 16 10 10 16 10 10 10 10 10 10 10 10 10 16 10 10 10 16 10 10 10 10 10 10 10 10 16
16 10 10 16 10 10 16 10 10 10 29 15 15 15 15 15 31 15 15 15 31 15 15 15 15 10 10 10 10 16
16 10 10 10 10 10 16 10 10 10 10 10 10 10 10 10 10 10 10 10 10 10 10 10 10 10 10 10 10 16
16 10 10 10 10 10 16 10 10 10 10 10 10 10 10 10 10 10 10 10 10 10 10 10 10 10 10 10 10 16
29 15 15 15 15 15 31 15 15 15 15 15 15 15 15 15 15 15 15 15 15 15 15 15 15 15 15 15 15 30 