27 15 15 15 15 15 15 15 15 15 15 15 15 15 15 15 15 15 32 15 15 15 15 15 15 15 15 15 15 28
16 70 70 70 70 70 70 70 70 70 70 70 70 70 70 70 70 70 70 70 70 70 70 70 70 70 70 70 70 16
16 70 70 70 70 70 70 70 70 70 70 70 70 70 70 70 70 70 70 70 70 70 70 70 70 70 70 70 70 16
16 70 70 16 70 70 70 70 70 70 70 70 70 70 70 70 70 70 70 70 70 70 70 70 70 70 70 70 70 16
16 70 70 16 70 70 70 70 70 70 70 70 70 70 70 70 70 70 70 70 70 70 70 70 70 70 70 70 70 16
16 70 70 29 15 28 70 70 70 70 27 70 26 15 32 15 26 70 28 70 70 70 70 70 70 70 70 70 70 16
16 70 70 70 70 33 70 70 70 70 16 17 17 17 16 17 17 17 16 70 70 70 70 70 32 15 15 15 15 30
16 70 70 70 70 16 70 70 70 70 16 17 17 17 16 17 17 17 16 70 70 70 70 70 16 70 70 70 70 70
16 70 70 70 70 16 70 70 70 70 16 20 17 19 16 20 17 19 16 70 70 70 70 70 70 70 70 70 70 70
33 15 15 15 15 30 14 14 14 15 35 15 15 15 35 15 15 15 34 70 70 70 70 70 70 70 70 70 70 70
16 14 14 14 14 14 14 14 14 14 16 20 17 19 16 20 17 19 16 70 70 70 70 70 70 70 70 70 70 70
16 14 38 14 14 14 14 14 14 14 16 17 17 17 16 17 17 17 16 70 70 15 15 15 28 70 70 70 70 70
16 14 36 37 14 14 14 14 14 14 16 17 17 17 16 17 17 17 16 70 70 70 70 70 33 15 15 15 15 28
16 14 14 14 14 14 15 15 32 15 30 70 26 15 30 70 26 15 30 70 70 70 70 70 16 70 70 70 70 16
16 70 70 70 70 70 70 70 70 70 70 70 70 70 70 70 70 70 70 70 70 70 70 70 70 70 70 70 70 16
16 70 70 70 70 70 70 70 70 70 70 70 70 70 70 70 70 70 70 70 70 70 70 70 70 70 70 70 70 16
16 70 70 70 70 70 70 70 70 70 70 70 70 70 70 70 70 70 70 70 70 70 70 70 16 70 70 70 70 16
29 15 15 15 15 15 15 15 15 15 15 15 15 15 15 15 15 15 15 15 15 15 15 15 31 15 15 15 15 30 