27 15 15 15 15 15 15 15 15 15 15 15 15 15 15 15 15 15 15 15 15 15 15 32 15 15 15 15 15 28
16 56 56 56 56 56 56 56 56 56 56 56 56 56 56 56 56 56 56 56 56 56 56 16 41 42 83 51 52 16
16 56 56 56 56 56 56 56 56 56 56 56 56 56 56 56 56 56 56 56 56 56 56 56 83 83 83 83 83 16
16 77 78 28 56 56 56 56 56 56 56 56 56 56 56 56 56 56 56 56 56 56 56 56 83 83 83 83 83 16
16 40 40 16 56 56 56 56 16 56 56 56 56 56 56 56 56 56 56 56 56 56 56 16 47 83 83 83 83 16
16 40 40 29 15 28 56 56 16 56 27 56 26 15 32 15 26 56 28 86 56 56 86 16 47 83 83 47 47 16
16 40 40 61 54 16 56 56 16 56 16 17 17 17 16 17 17 17 16 87 56 56 87 29 32 77 78 15 15 30
16 40 40 40 40 16 56 56 16 56 16 17 17 17 16 17 17 17 16 70 70 70 70 70 16 70 70 70 70 90
16 62 40 40 40 16 56 56 16 56 16 20 17 19 16 20 17 19 16 70 70 70 70 70 30 70 70 70 70 90
33 15 40 40 40 31 77 78 31 70 35 15 15 15 35 15 15 15 34 70 70 70 70 70 70 70 70 70 70 90
16 55 14 14 14 14 14 14 79 14 16 20 17 19 16 20 17 19 16 70 70 70 70 70 70 70 70 70 70 90
16 14 38 14 14 14 14 14 14 14 16 17 17 17 16 17 17 17 33 15 15 15 70 70 28 70 70 70 70 90
16 14 36 37 14 14 14 14 14 14 16 17 17 17 16 17 17 17 16 62 63 40 40 40 33 15 15 15 15 28
16 15 15 15 15 15 15 70 70 15 34 70 26 15 30 70 26 15 34 40 40 40 40 40 16 11 11 11 11 16
16 70 70 70 70 70 70 70 70 70 16 70 70 70 70 70 70 70 70 40 40 40 40 40 70 11 11 11 11 16
16 70 70 70 70 70 70 70 70 70 70 70 70 70 70 70 70 70 70 40 40 40 40 40 70 11 11 11 11 16
16 70 70 70 70 70 70 70 70 70 70 70 70 70 70 70 70 70 16 45 46 40 40 40 16 11 11 11 11 16
29 15 15 15 15 15 15 15 15 15 15 15 15 15 15 15 15 15 31 15 15 15 15 15 31 15 15 15 15 30 