27 77 78 15 15 15 15 15 15 15 15 15 15 15 15 15 15 15 15 15 32 15 15 15 15 32 15 15 15 28
16 70 70 70 70 70 70 70 70 70 70 70 70 70 70 70 70 70 70 70 16 41 42 51 52 16 86 88 86 16
16 70 70 70 70 70 70 70 70 70 70 70 70 70 70 70 70 70 70 70 70 13 13 13 13 13 87 56 87 16
16 70 70 70 70 70 27 86 70 70 86 15 15 15 28 70 70 70 70 70 70 13 13 13 13 13 56 56 56 16
33 15 15 15 15 15 30 87 56 56 87 56 56 56 16 70 70 70 70 70 27 15 77 78 15 28 56 56 56 16
16 55 14 14 14 79 70 56 56 56 56 56 56 56 16 70 70 15 15 15 34 53 40 40 54 16 56 56 56 16
16 14 38 14 14 14 70 56 56 56 56 56 56 56 16 14 14 50 14 75 16 40 40 40 40 16 56 56 56 16
16 36 37 14 14 14 16 56 56 56 56 56 56 56 16 14 14 14 14 76 16 40 40 40 40 70 56 56 56 21
16 14 14 14 14 14 16 56 56 56 56 56 56 56 16 36 37 14 14 14 16 47 73 74 40 70 56 56 56 22
33 15 15 15 15 15 35 77 78 15 32 15 70 70 29 15 15 14 14 14 29 15 15 15 15 28 56 56 56 23
16 40 62 63 40 79 16 70 70 70 16 89 17 17 17 17 14 14 14 14 70 13 47 13 81 16 56 56 56 24
16 40 40 40 40 40 16 70 70 70 16 89 17 17 17 17 14 14 14 14 70 13 13 13 13 16 56 56 56 25
16 40 40 40 40 40 70 70 70 70 70 17 17 17 17 19 16 14 14 14 16 13 13 13 13 70 56 56 56 16
16 40 36 37 40 40 70 70 70 70 70 17 17 17 17 19 16 14 14 14 16 45 46 47 13 70 56 56 56 16
16 40 40 40 40 40 16 70 70 70 29 15 15 15 15 15 31 77 78 15 31 15 15 15 15 30 56 56 56 16
16 40 40 40 40 40 16 70 70 70 70 70 70 70 70 70 70 70 70 70 70 70 70 70 70 70 56 56 56 16
16 64 65 40 40 47 16 70 70 70 70 70 70 70 70 70 70 70 70 70 70 70 70 70 70 70 56 56 56 16
29 15 15 15 15 15 31 15 15 15 15 15 15 15 15 15 15 15 15 15 15 15 15 15 15 15 15 15 15 30 