15 15 15 15 15 15 15 15 15 15 15 15 15 15 15 15 15 15 15 15 15 15 15 15 15 15 15 15 15 15
16 10 10 10 10 10 10 10 10 10 10 10 10 10 10 10 10 10 16 11 11 11 11 11 11 11 11 11 11 16
16 10 10 10 10 10 10 10 10 10 10 10 10 10 10 10 10 10 16 11 11 11 11 11 11 11 11 11 11 16
16 10 10 10 10 10 10 10 10 10 10 10 10 10 10 10 10 10 16 11 11 11 11 11 11 11 11 11 11 16
16 10 10 10 10 10 10 10 10 10 10 10 10 10 16 15 15 15 15 11 11 11 11 11 11 11 11 11 11 16
16 10 10 10 10 16 10 10 10 10 10 10 10 10 16 10 10 10 10 11 11 11 11 11 11 11 11 11 11 16
16 10 10 10 10 16 10 10 10 10 10 10 10 10 10 10 10 10 10 15 15 15 15 15 15 15 15 15 15 16
16 10 10 10 10 16 10 10 10 10 10 10 10 10 10 10 10 10 10 10 10 10 10 10 16 10 10 10 10 10
16 10 10 10 10 16 10 10 10 10 10 10 10 10 16 10 10 10 10 10 10 10 10 10 10 10 10 10 10 10
16 15 15 15 15 15 14 14 14 15 15 15 15 15 15 15 15 15 15 10 10 10 10 10 10 10 10 10 10 10
16 14 14 14 14 14 14 14 14 14 16 20 17 17 16 20 17 17 16 10 10 10 10 10 10 10 10 10 10 10
16 14 14 14 14 14 14 14 14 14 16 17 17 17 16 17 17 17 16 10 10 15 15 15 16 10 10 10 10 10
16 14 14 14 14 14 14 14 14 14 16 17 17 17 16 17 17 17 16 10 10 10 10 10 15 15 15 15 15 16
16 14 14 14 14 14 15 15 15 15 16 10 26 15 16 10 26 15 16 10 10 10 10 10 16 10 10 10 10 16
16 10 10 10 10 10 10 10 16 10 10 10 10 10 10 10 10 10 10 10 10 10 10 10 10 10 10 10 10 16
16 10 10 10 10 10 10 10 10 10 10 10 10 10 10 10 10 10 10 10 10 10 10 10 10 10 10 10 10 16
16 10 10 10 10 10 10 10 10 10 10 10 10 10 10 10 10 10 10 10 10 10 10 10 16 10 10 10 10 16
15 15 15 15 15 15 15 15 15 15 15 15 15 15 15 15 15 15 15 15 15 15 15 15 15 15 15 15 15 15 