27 15 15 15 15 15 15 15 15 32 15 15 15 15 32 15 15 15 15 15 15 15 15 15 15 15 15 15 15 28
16 41 42 13 51 52 13 41 42 16 10 10 10 10 10 10 39 39 39 39 39 39 39 62 63 39 39 39 61 16
16 13 13 13 13 13 13 13 13 10 10 10 10 10 10 10 39 39 39 39 39 39 39 39 39 39 39 39 39 16
16 13 13 13 13 13 13 13 13 10 10 10 10 10 10 10 39 39 39 39 39 39 39 39 39 39 39 39 39 16
16 45 46 13 47 47 13 13 13 16 10 10 10 10 10 15 15 15 15 15 15 15 28 39 39 39 39 39 39 16
33 15 15 15 32 15 15 15 32 30 10 10 10 10 10 10 10 10 10 10 10 10 16 64 65 39 39 39 39 16
16 20 17 19 16 20 17 19 16 10 10 10 10 10 10 10 10 10 10 10 10 10 29 15 15 10 10 15 15 30
16 17 17 17 16 17 17 17 16 10 10 10 10 27 15 15 15 15 15 28 10 10 10 57 56 56 56 56 56 10
16 17 17 17 16 17 17 17 16 10 10 10 10 16 13 43 13 43 13 16 10 10 10 58 56 56 56 56 56 10
33 15 18 10 31 15 18 10 30 10 10 10 10 13 13 13 13 13 13 13 10 10 10 59 56 56 56 56 56 10
16 10 10 10 10 10 10 10 10 10 10 10 10 13 13 13 13 13 13 13 10 10 10 60 56 56 56 56 56 10
16 10 10 10 10 10 10 10 10 10 10 10 10 16 13 44 13 44 13 16 10 10 10 56 56 56 56 56 56 10
16 10 10 10 10 10 10 10 10 10 10 10 10 29 15 15 15 15 15 30 10 10 27 15 48 49 10 10 15 28
33 15 18 10 27 15 18 10 16 10 10 10 10 10 10 10 10 10 10 10 10 10 16 50 14 14 14 14 14 16
16 17 17 17 16 17 17 17 16 10 10 10 10 10 10 10 27 15 15 15 15 15 30 14 14 14 14 14 14 16
16 17 17 17 16 17 17 17 16 10 10 10 10 10 10 10 16 55 14 14 53 54 14 14 14 14 14 14 14 16
16 20 17 19 16 20 17 19 16 10 10 10 10 10 10 10 16 14 14 14 14 14 14 14 14 14 14 14 14 16
29 15 15 15 31 15 15 15 31 15 15 15 15 15 15 15 31 15 15 15 15 15 15 15 15 15 15 15 15 30